________________________________________________________________________
########################################################################
#                                                                      #
#                                                                      #
# ##########################################                           #
#                                            #######                   #
#                                                   #####              #
########################################>                ####          #
#                                                            ###       #
#                                                               ##     #
####################################################>    ##       #    #
#                                                                  #   #
#                                                          #HH#     #  #
#######################################################>   ####     #  #
#                                                          #  #     #  #
#                                                                   #  #
####################################################>    ##        #   #
#                                                                 #    #
#                                                               ##     #
########################################>                    ###       #
#                                                        ####          #
#                                                   #####              #
#                                             ######                   #
############################################                           #
########################################################################
________________________________________________________________________
