________________________________________________________________________
########################################################################
#                                                                      #
#          ###################################   ###################   #
#          #                                     #                 #   #
#          #                                     #                 #   #
#          #     #############################   #    ######       #   #
#          #                                 #   #    # c          #   #
#          #                                 #   #    ##############   #
#          #######################   #########   #                     #
#                                                #                     #
#                                            #   #######################
#          #  <#########################>    #                         #
#          #  <#                       #>    #                         #
#          #  <#              c        #>    #     #################   #
#          #  <#                       #>    #     #   <#          #   #
#          #  <#                       #>    #     #   <#          #   #
#          #  <##########  #############>    #     #   <# ^^^^^^^      #
#                                            #     #   <# ##############
#                                            #     #   <#              #
#          #                                 #     #   <#              #
#          #                                 #######   <#              #
#          #                                           <#              #
#          #^^^^^^^^^^^^^^^^^^^^^^^^^^^^^^^^^^^^^^^^^^^^#^^^^^^^^^^^^^^#
########################################################################
________________________________________________________________________