________________________________________________________________________
########################################################################
#                                                                      #
#                                                                      #
#                                                                      #
#                                                                      #
#  #####################   ##########################   #############  #
#  #                       #                            #              #
#  #                       #                            #              #
#  #                       #                            #              #
#  #                       #                            #              #
#                                                                      #
#  #####################   ##########################   #############  #
#  #                       #                            #              #
#  #                       #                            #              #
#  #                       #                            #              #
#  #                       #                            #              #
#                                                                      #
#  #####################   ##########################   #############  #
#  #                       #                            #c             #
#  #                       #                            #              #
#  #                       #                            #              #
#  #                       #                            #              #
#                                                                      #
########################################################################
________________________________________________________________________