________________________________________________________________________
  ####################################################################
  #                                                                  #
  #                                                                  #
  #      ###############################  #####################      #
  #                                     #                     #      #
  ################################ ######################     #      #
  #                                  #                        #      #
  #                              #   #                        #      #
  #                              #   #   #   ############     #      #
  #                              #       #          #H        #      #
  #                              #   #####   #      #         #      #
  #                              #           #      #         #      #
  #                              #    #      #      #         #      #
  #                              #    #      #      # #########      #
  #                         #    #    #      #      #    #c          #
  #  ##########             #    #    ########      #    #############
  #     #     #             #    #                  #                #
  #     #                   #    #                  #                #
  #     #     #             #    ####################                #
  #     #     #             #                                 +      #
  #     #     #             #                                        #
  ####################################################################
________________________________________________________________________
