________________________________________________________________________
########################################################################
#                                                                      #
#                                                                      #
#                                                                      #
#                ####                               ####               #
#              ##    ##                           ##    ##             #
#                 cc   #                             cc   #            #
#             #        #                         #        #            #
#              ##    ##                           ##    ##             #
#                ####              #                ####               #
#                                   #                                  #
#                                    #                                 #
#                                     #                                #
#           #                     ####                     #           #
#           #                                              #           #
#            #                                            #            #
#             ##                                        ##             #
#               ####                                ####               #
#                   #######                  #######                   #
#                          ##################                          #
#                                                                      #
#                                                                      #
#                                                                      #
########################################################################
________________________________________________________________________